ENSP00000155840
ENSP00000155926
ENSP00000161559
ENSP00000183605
ENSP00000200676
ENSP00000211413
ENSP00000215794
ENSP00000217188
ENSP00000217407
ENSP00000219235
ENSP00000219919
ENSP00000221476
ENSP00000222382
ENSP00000222481
ENSP00000223293
ENSP00000225823
ENSP00000226279
ENSP00000226299
ENSP00000228928
ENSP00000231420
ENSP00000233954
ENSP00000234313
ENSP00000241125
ENSP00000241261
ENSP00000243346
ENSP00000243611
ENSP00000244043
ENSP00000244709
ENSP00000246532
ENSP00000248598
ENSP00000248706
ENSP00000248933
ENSP00000250003
ENSP00000251642
ENSP00000252037
ENSP00000252593
ENSP00000253110
ENSP00000254436
ENSP00000255695
ENSP00000256722
ENSP00000257570
ENSP00000257818
ENSP00000258381
ENSP00000258787
ENSP00000259455
ENSP00000259727
ENSP00000260184
ENSP00000260283
ENSP00000260302
ENSP00000260442
ENSP00000261267
ENSP00000262510
ENSP00000262629
ENSP00000262878
ENSP00000263071
ENSP00000263265
ENSP00000263549
ENSP00000263642
ENSP00000264012
ENSP00000264346
ENSP00000264350
ENSP00000264717
ENSP00000264972
ENSP00000265598
ENSP00000268070
ENSP00000269202
ENSP00000269389
ENSP00000270560
ENSP00000270800
ENSP00000272134
ENSP00000278407
ENSP00000278550
ENSP00000278742
ENSP00000280684
ENSP00000281043
ENSP00000283357
ENSP00000284292
ENSP00000286744
ENSP00000287020
ENSP00000287156
ENSP00000288490
ENSP00000293670
ENSP00000293894
ENSP00000294338
ENSP00000294454
ENSP00000294728
ENSP00000296161
ENSP00000296443
ENSP00000296795
ENSP00000298351
ENSP00000298943
ENSP00000301175
ENSP00000301200
ENSP00000301310
ENSP00000301653
ENSP00000301691
ENSP00000301887
ENSP00000302079
ENSP00000302144
ENSP00000302621
ENSP00000302629
ENSP00000303766
ENSP00000305651
ENSP00000305941
ENSP00000306099
ENSP00000306361
ENSP00000306884
ENSP00000308597
ENSP00000308815
ENSP00000310632
ENSP00000311746
ENSP00000315768
ENSP00000317674
ENSP00000318234
ENSP00000318258
ENSP00000318982
ENSP00000319250
ENSP00000319254
ENSP00000319781
ENSP00000322649
ENSP00000323929
ENSP00000325618
ENSP00000325808
ENSP00000326247
ENSP00000327246
ENSP00000328174
ENSP00000328677
ENSP00000329418
ENSP00000331268
ENSP00000331288
ENSP00000333266
ENSP00000333657
ENSP00000336829
ENSP00000337224
ENSP00000337383
ENSP00000338774
ENSP00000340914
ENSP00000340975
ENSP00000341045
ENSP00000341141
ENSP00000341236
ENSP00000342007
ENSP00000342278
ENSP00000342513
ENSP00000343490
ENSP00000344041
ENSP00000344208
ENSP00000344577
ENSP00000344820
ENSP00000345494
ENSP00000346206
ENSP00000347942
ENSP00000348300
ENSP00000349709
ENSP00000350036
ENSP00000353128
ENSP00000353132
ENSP00000353203
ENSP00000353210
ENSP00000353512
ENSP00000354376
ENSP00000354394
ENSP00000354822
ENSP00000355330
ENSP00000356033
ENSP00000356104
ENSP00000356590
ENSP00000357060
ENSP00000357080
ENSP00000357113
ENSP00000357461
ENSP00000357727
ENSP00000358470
ENSP00000359022
ENSP00000359319
ENSP00000359454
ENSP00000359488
ENSP00000359490
ENSP00000359504
ENSP00000359512
ENSP00000359526
ENSP00000359783
ENSP00000359787
ENSP00000360215
ENSP00000360217
ENSP00000360247
ENSP00000360869
ENSP00000360883
ENSP00000360891
ENSP00000361366
ENSP00000361785
ENSP00000362690
ENSP00000362778
ENSP00000363001
ENSP00000363031
ENSP00000363270
ENSP00000363583
ENSP00000363993
ENSP00000364034
ENSP00000365227
ENSP00000366387
ENSP00000367185
ENSP00000367570
ENSP00000367851
ENSP00000368523
ENSP00000368566
ENSP00000368664
ENSP00000368699
ENSP00000369213
ENSP00000369292
ENSP00000369293
ENSP00000369299
ENSP00000369581
ENSP00000370408
ENSP00000370989
ENSP00000371018
ENSP00000371471
ENSP00000371770
ENSP00000371824
ENSP00000372169
ENSP00000372221
ENSP00000372612
ENSP00000373574
ENSP00000373964
ENSP00000374633
ENSP00000375066
ENSP00000375430
ENSP00000375795
ENSP00000375899
ENSP00000376417
ENSP00000376553
ENSP00000376848
ENSP00000377344
ENSP00000377411
ENSP00000377570
ENSP00000378130
ENSP00000379034
ENSP00000379092
ENSP00000379258
ENSP00000379290
ENSP00000379571
ENSP00000379826
ENSP00000380258
ENSP00000380421
ENSP00000380697
ENSP00000380855
ENSP00000380948
ENSP00000381601
ENSP00000382646
ENSP00000382707
ENSP00000383641
ENSP00000384192
ENSP00000384906
ENSP00000385247
ENSP00000385675
ENSP00000386187
ENSP00000386203
ENSP00000386230
ENSP00000386280
ENSP00000386845
ENSP00000387435
ENSP00000387683
ENSP00000388001
ENSP00000390410
ENSP00000391583
ENSP00000393987
ENSP00000395590
ENSP00000397073
ENSP00000397911
ENSP00000398342
ENSP00000398637
ENSP00000399518
ENSP00000399679
ENSP00000400646
ENSP00000401399
ENSP00000401437
ENSP00000401645
ENSP00000404232
ENSP00000407726
ENSP00000410533
ENSP00000411355
ENSP00000412189
ENSP00000415026
ENSP00000416561
ENSP00000416673
ENSP00000417401
ENSP00000417898
ENSP00000418194
ENSP00000419162
ENSP00000421853
ENSP00000422188
ENSP00000425493
ENSP00000426174
ENSP00000427015
ENSP00000430950
ENSP00000432651
ENSP00000433138
ENSP00000433490
ENSP00000434676
ENSP00000436714
ENSP00000438615
ENSP00000439120
ENSP00000440374
ENSP00000441685
ENSP00000443191
ENSP00000444211
ENSP00000448248
ENSP00000452786
ENSP00000457539
ENSP00000462701
ENSP00000463778
ENSP00000464087
ENSP00000469613
ENSP00000470555
ENSP00000473159
ENSP00000475084
ENSP00000477341
ENSP00000478257
ENSP00000478830
ENSP00000479362
ENSP00000482604
ENSP00000483430
ENSP00000484658
ENSP00000484689
ENSP00000485061
ENSP00000485478
